{
	"width": 10,
	"height": 10,
	"map": [1,1,1,1,1,1,1,1,1,1,
			1,0,0,0,0,0,0,0,0,1,
			1,0,0,0,0,0,0,0,0,1,
		    1,0,0,0,2,0,0,0,0,1,
			1,0,0,1,0,1,0,0,0,1,
			1,0,2,0,0,0,2,0,0,1,
			1,0,0,1,0,1,0,0,0,1,
			1,0,0,0,2,0,0,0,0,1,
			1,0,0,0,0,0,0,0,0,1,
			1,1,1,1,1,1,1,1,1,1],
	"player_respawns":[44,17, 77],
	"bot_respawns": [81,18]
}